111111111111111
100E0000C000001
100000000000001
1000000C000P001
111111111111111