111111111111111
100E0000C000001
100000000011101
1000000C001P001
111111111111111