
111111111111111
1E100000C000001
1C1000000011101
1000000C001P001
111111111111111
